##########
#   P    #
#        #
#        #
#   x    #
#        #
#        #
#        #
# o      #
##########